R 1000    500

NO    /media/sf_cub3d/textures/eagle.xpm
SO /media/sf_cub3d/textures/wood.xpm
EA    /media/sf_cub3d/textures/greystone.xpm
WE /media/sf_cub3d/textures/bluestone.xpm

S         /media/sf_cub3d/textures/guard.xpm

C 57, 50, 230
F 57, 50, 76


11111111111111111111  
100000000000001000011
1100000000S00010000011
 1111110000000100000011
   111100000000000000011
    100000200000000200011
    110001111000200000001
   1100001111000000200011
 11102000000000000000011
11000020000001111000111
1100000100000111000011
100011110000000000011
10020000002000020001
10000000000020000001
11111111111111111111  
