R 500 500

NO ../textures/bluestone.xpm
SO ../textures/colorstone.xpm
EA ../textures/greystone.xpm
WE ../textures/redbrick.xpm

S ../textures/marvin.xpm

C 225,30,0
F 220, 100, 0


11111111111111111111
100N1111100011100011
10000111111111111111
1110111     111   11
1000001     111   11
10000011111111 11111111
11101111111111  1111111 
  111 
