R 5000 2000

NO    ./textures/42sp.xpm
SO ./textures/redbrick.xpm
EA    ./textures/greystone.xpm
WE ./textures/eagle.xpm

S         ./textures/guard.xpm

C 50, 50, 230
F 57, 50, 76


11111111111111111111
10000000000000000001111
11110S00000000110000001
11110000000200010000001
11000000000000010001111
11000020011100000000111
 111000000000011000000111
 111000000100011002000001
  10000011100000000001111
 110000000000001100001
 100000000000000000011
 11111111111111111111
