R 1000 800

NO /media/sf_cub3d/textures/bluestone.xpm
SO /media/sf_cub3d/textures/colorstone.xpm
EA /media/sf_cub3d/textures/greystone.xpm
WE /media/sf_cub3d/textures/redbrick.xpm

S /media/sf_cub3d/textures/marvin.xpm

C 57, 50, 230
F 57, 50, 76


11111111111111111111  
100S1111100011100011   
12000111111111111111     
1110111     111   11
1000001     111   11          
10000011111111 11111111
10000000000001
10000000000001
10000000000001
10000110000001
10000110000001
12000000000021
10200000000001
10020000000001
10002000000001
10000000000001
10000000000001
10000000000001
10000000000001
10000000000001
10000000000001
10000000000001
10000000000001
10000000000001
11101111111111   
  111 
