R 500 500
F 100, 100, 110
C 0,0,50

NO    ./textures/42sp.xpm
SO ./textures/redbrick.xpm
EA    ./textures/greystone.xpm
WE ./textures/eagle.xpm

S  ./textures/marvin.xpm

11111111111111111111111
10000000000000010000001
10000020000000010000001
10000000000000010000001
10000000000200010000001111111111
10000000000000000000000000000001
11110000000000000000200000000001
   10000200000000000000000000001
   10000000000000000000000111111
111100000000000000200000001
100000000000011110000000001
10000000000001  100000000011111
10020000000001  100000000000001
10000000000001111000N0000000001
1000000000000000000000000000001
1000111111110000001111111111111
10001      10000001
10001      10200001
11111      11111111
