R 1000 500

NO    ./textures/42sp.xpm
SO ./textures/redbrick.xpm
EA    ./textures/greystone.xpm
WE ./textures/eagle.xpm

S         ./textures/guard.xpm

C 50, 50, 230, 12
F 57, 50, 76


11111111111111111111
10000000000000000001111
11110S00000200110000001
11110000000000010022001
11002020010100010001111
11000200011102000000111
 111000000000011002000111
 111000100100011000000001
  12000111100000000001111
 110002000000001100001
 102000000000000000011
 11111111111111111111
